00 00 00 00 00 00 00 00 12 13 13 13 13 13 13 27 16 16 16 16 16 16 16 16 16 16 16 16 16 16 16 16 16 16 16 16 16 16 26 13                                                                                                                                                                                                                                                                                                                                                                                                                                                                                               
00 00 00 00 00 00 00 00 12 13 13 13 13 13 27 17 19 19 19 19 19 19 19 19 19 19 19 19 19 19 19 19 19 19 19 19 19 19 15 26                                                                                                                                                                                                                                                                                                           
00 00 00 00 00 00 00 00 15 16 16 16 16 16 17 20 22 22 22 22 22 22 22 22 22 22 22 22 22 22 22 22 22 22 22 22 22 22 18 12                                                                                                                         
11 00 00 00 00 00 00 00 18 19 19 19 19 19 20 23 00 00 00 00 00 00 00 00 00 00 00 00 00 00 00 00 00 00 00 00 00 00 18 12                                                                                                                                                                          
14 00 00 00 00 00 00 00 21 22 22 22 22 22 23 00 00 00 00 00 00 00 00 00 00 00 00 00 00 00 00 00 00 00 00 00 00 00 21 12                                                                                                                                                
25 10 10 11 00 00 00 00 00 00 00 00 00 00 00 00 00 00 00 00 00 00 00 00 00 00 00 00 00 00 00 00 00 00 00 00 00 00 00 12                                                                                   
13 13 13 25 11 00 00 00 00 00 00 00 00 00 00 00 00 00 00 00 00 00 00 00 00 00 00 00 00 00 00 00 00 00 00 00 00 00 00 12                                                                                                                  
13 13 13 13 14 00 00 00 00 00 00 00 00 00 00 00 00 00 00 00 00 00 00 00 00 00 00 00 00 00 00 00 00 00 00 00 00 00 00 12                                                        
13 27 16 16 17 00 00 00 00 00 00 00 00 00 00 00 00 00 00 00 00 00 00 00 00 00 00 00 00 00 00 00 00 00 00 00 00 00 00 12                                                                                                                                         
27 17 19 19 20 00 00 00 00 00 00 00 00 00 00 00 00 00 00 00 00 00 00 00 00 00 00 00 00 00 00 00 00 00 00 00 00 00 00 12                                                                                                
14 20 19 19 20 00 00 00 00 00 00 00 00 00 00 00 00 00 00 00 00 00 00 00 00 00 00 00 00 00 00 00 00 00 00 00 00 00 00 12                                                                                                                  
14 20 19 19 20 00 00 00 00 00 00 00 00 00 00 00 00 00 00 00 00 00 00 00 00 00 00 09 10 10 10 10 10 10 11 00 00 00 00 12                                                                                                                                    
14 20 19 19 20 00 00 00 00 00 00 00 00 00 00 00 00 00 00 00 00 00 00 00 00 00 00 12 13 13 13 13 13 27 17 00 00 00 00 12                                                                                             
14 20 22 22 23 00 00 00 00 00 00 00 00 00 00 00 00 00 00 00 00 00 00 00 00 00 00 12 13 13 13 13 27 17 20 00 00 00 00 12                                                                                                                                      
14 20 00 00 00 00 00 00 00 00 00 00 00 00 00 00 00 00 00 00 00 00 00 00 00 00 00 12 13 13 13 27 17 20 20 00 00 00 00 12                                                                                              
14 20 00 00 00 00 00 00 00 00 00 00 00 00 00 00 00 00 00 00 00 00 00 00 00 00 00 12 13 13 27 17 20 20 20 00 00 00 00 12                                                                                                            
14 23 00 00 00 00 00 00 00 00 00 00 00 00 00 00 00 00 00 00 00 00 00 00 00 00 00 12 13 27 17 20 20 20 23 00 00 00 00 12                                                                                                                  
14 00 00 00 00 00 00 00 00 00 00 00 00 00 00 00 00 00 00 00 00 00 00 00 00 00 00 15 16 17 20 20 20 23 00 00 00 00 09 24                                                                                                    
14 00 00 00 00 00 00 00 00 00 00 00 00 00 00 00 00 00 00 00 00 00 00 00 00 00 00 18 19 20 20 20 23 00 00 00 00 09 24 13                                                                        
14 00 00 00 00 00 00 00 00 00 00 00 00 00 00 00 00 00 00 00 00 00 00 00 00 00 00 18 19 20 20 23 00 00 00 00 09 24 13 13                                                                                                                                                     
14 00 00 00 00 00 00 00 00 00 00 00 00 00 00 00 00 00 00 00 00 00 00 00 00 00 00 18 19 20 23 00 00 00 00 09 24 13 13 13                                                                                            
14 00 00 00 00 00 00 00 00 00 00 00 00 00 00 00 00 00 00 00 00 00 00 00 00 00 00 21 22 23 00 00 00 00 09 24 13 13 13 13                                                          
14 00 00 00 00 00 00 00 00 00 00 00 00 00 00 00 00 00 00 00 00 00 00 00 00 00 00 00 00 00 00 00 00 09 24 13 13 13 13 13                                                              
14 00 00 00 00 00 00 00 00 00 00 00 00 00 00 00 00 00 00 00 00 00 00 00 00 00 00 00 00 00 00 00 00 15 16 16 16 16 16 16                                                                                                                                                                       
14 00 00 00 00 00 00 00 00 00 00 00 00 00 00 00 00 00 00 00 00 00 00 00 00 00 00 00 00 00 00 00 00 18 19 19 19 19 19 19                                                                          
14 00 00 00 00 00 00 00 00 00 00 00 00 00 00 00 00 00 00 00 00 00 00 00 00 00 00 00 00 00 00 00 00 18 19 19 19 19 19 19                                                                                
14 00 00 00 00 00 00 00 09 10 10 10 10 11 00 00 00 00 00 00 00 00 00 00 00 00 00 00 00 00 00 00 00 21 22 22 22 22 22 22                                                                 
25 11 00 00 00 09 10 10 24 13 13 13 13 25 10 10 11 00 00 00 09 10 10 11 00 00 00 00 00 00 00 00 00 00 00 00 00 00 00 00                                                                                                                
13 25 10 10 10 24 13 13 13 13 13 13 13 13 13 13 25 10 10 10 24 13 13 25 10 10 11 00 00 00 00 00 00 00 00 00 00 00 00 00                                                                                                                        
13 13 13 13 13 13 13 13 13 13 13 13 13 13 13 13 13 13 13 13 13 13 13 13 13 13 25 10 10 10 10 10 10 10 10 10 10 10 10 10  



























































































































































































