03 03 03 03 03 03 03 03 00 00 00 00 00 00 00 00 00 00 00 00 00 00 00 00 00 00 00 00 00 00 00 00 00 00 00 00 00 00 00 00                                                                                                                                                                                                                                                                                                                                                                                                                                                                                                                                                                                                                                                                          
03 01 04 03 03 01 01 03 00 00 00 00 00 00 00 00 11 11 11 11 11 11 11 11 11 11 11 11 11 11 11 11 11 11 11 11 11 11 00 00                                                                                                                                                                                                                                                                                                                                          
01 03 01 03 03 01 03 03 00 00 00 00 00 00 00 12 11 11 11 11 11 11 11 11 11 11 11 11 11 11 11 11 11 11 11 11 11 11 10 00                                                                                                                                                                                 
01 03 03 03 01 01 01 01 10 11 11 11 11 11 12 12 14 14 14 14 14 14 14 14 14 14 14 14 14 14 14 14 14 14 14 14 14 14 10 00                                                                                                                                                                                                                              
03 01 01 03 04 04 04 04 10 11 11 11 11 11 12 15 01 01 01 01 04 04 01 01 01 01 01 01 01 01 01 01 01 03 03 03 03 03 10 00                                                                                                                                                                                 
03 03 03 01 04 04 04 04 13 14 14 14 14 14 15 01 01 01 01 01 01 04 04 01 01 01 01 01 01 01 01 01 01 03 03 03 03 03 13 00                                                                                                                        
00 04 04 03 04 04 01 01 01 01 01 01 01 01 01 01 01 01 01 04 04 01 01 01 01 04 01 01 01 03 01 04 01 01 03 03 03 01 03 00                                                                                                                                                          
00 04 01 04 01 04 01 01 01 01 04 01 01 01 01 01 01 04 04 04 04 01 04 04 04 04 01 01 01 03 01 04 01 01 03 03 01 03 03 00                                                                                   
00 00 00 00 06 01 01 01 01 03 03 03 04 04 01 01 01 04 04 04 01 01 01 04 04 04 04 01 03 03 03 04 01 01 01 03 03 03 01 00                                                                                                                                                                             
00 00 00 00 00 01 01 01 04 03 03 03 03 04 01 01 01 01 01 01 01 01 01 04 01 04 04 01 04 04 01 01 01 01 01 01 03 03 03 00                                                                                                                                     
00 00 00 00 00 01 01 01 01 04 04 03 04 01 01 01 01 01 01 01 01 04 01 01 01 01 01 01 01 01 01 01 03 01 01 01 01 03 03 00                                                                                                                                                                
00 00 11 11 12 01 01 01 01 04 03 01 01 01 01 01 01 04 01 01 01 01 04 01 01 01 01 01 01 01 01 01 01 01 01 01 01 01 03 00                                                                                                                                                              
00 00 11 11 12 01 01 01 01 01 03 03 01 01 01 01 01 04 03 04 04 04 03 03 01 01 01 00 00 00 00 00 00 00 00 01 01 01 01 00                                                                                                                                              
00 00 14 14 15 01 01 01 01 04 01 04 01 01 01 01 01 04 04 03 03 04 03 03 01 01 01 00 00 00 00 00 00 00 12 01 01 01 01 00                                                                                                                                                             
00 12 01 01 01 01 01 01 01 01 01 01 01 01 01 01 01 01 03 03 03 03 03 01 01 01 01 00 00 00 00 00 00 12 12 01 04 01 01 00                                                                                                                            
00 12 01 01 01 01 01 01 01 01 01 04 04 01 01 01 04 03 04 04 03 04 03 01 01 01 01 00 00 00 00 00 12 12 15 01 01 04 04 00                                                                                                                                                
00 15 01 01 01 01 01 01 01 01 04 04 04 01 01 01 04 03 03 03 04 03 04 01 01 01 01 00 00 00 00 12 12 15 04 04 04 04 04 00                                                                                                                                                     
00 01 01 01 01 01 01 01 01 04 04 03 04 04 01 01 01 01 01 04 01 01 04 04 01 01 01 00 00 00 12 12 15 01 03 04 01 01 01 00                                                                                                                                                         
00 01 01 01 01 01 05 04 01 04 03 03 03 04 01 01 01 01 01 01 01 01 01 04 01 01 01 10 11 12 12 15 04 03 04 04 01 01 00 00                                                                                                              
00 01 04 01 04 01 01 01 04 04 04 03 04 04 04 04 01 01 01 01 01 01 04 04 01 01 01 10 11 12 15 04 04 03 04 04 01 00 00 00                                                                                                                                                                                    
00 01 04 04 04 04 01 01 01 01 04 01 04 01 04 04 04 01 04 04 04 04 01 01 01 01 01 13 14 15 01 04 03 03 04 01 00 00 00 00                                                                                                                                         
00 01 04 03 03 03 04 01 01 01 01 01 01 01 01 01 01 04 04 03 03 04 01 01 01 01 01 01 01 01 01 03 03 04 04 00 00 00 00 00                                                                                    
00 01 03 03 04 03 04 01 01 01 01 01 01 01 01 01 04 03 03 04 03 04 04 01 01 01 01 01 01 01 04 01 04 04 00 00 00 00 00 00                                                                               
00 04 04 03 04 04 04 01 04 04 01 01 01 01 01 01 04 03 03 04 03 03 04 01 01 01 01 01 01 01 04 04 01 00 00 00 00 00 00 00                                                                                                                                                                                              
00 04 03 04 01 04 04 01 01 01 04 01 01 01 01 01 01 04 03 03 03 04 04 04 04 01 01 01 01 01 04 01 03 10 11 11 11 11 11 11                                                                                                                          
00 01 01 03 03 03 01 01 01 01 01 01 01 01 01 01 01 04 04 04 01 04 01 01 04 03 04 01 01 01 04 03 03 10 11 11 11 11 11 11                                                                                                                                
00 01 01 01 01 01 01 01 01 01 01 01 01 01 01 01 01 01 01 01 01 01 01 01 01 04 01 04 04 04 04 03 03 13 14 14 14 14 14 14                                                                                                               
00 01 01 01 01 01 01 01 00 00 00 00 00 00 01 01 01 01 01 01 01 01 01 01 01 01 01 04 04 04 04 04 01 03 03 03 03 03 03 04                                                                                                                                                  
00 00 01 01 01 00 00 00 00 00 00 00 00 00 00 00 00 01 01 01 00 00 00 00 01 01 01 03 03 01 04 03 03 03 04 04 03 03 04 03                                                                                                                                                        
00 00 00 00 00 00 00 00 00 00 00 00 00 00 00 00 00 00 00 00 00 00 00 00 00 00 00 01 04 03 03 01 03 01 03 04 03 03 03 03















