00 07 08 00 02 00 07 08 00 00 00 00 00 00 00 00 00 00 00 00 00 00 00 00 00 00 00 00 00 00 00 00 00 00 00 00 00 00 00 00                                                                                                                                                                                                                                                                                                                                                                                                                                                                                                                                                                                                                                                                                                                
02 09 10 03 00 15 09 10 00 00 00 00 00 00 00 00 00 00 00 00 00 00 00 00 00 00 00 00 00 00 00 00 00 00 00 00 00 00 00 00                                                                                                                                                                                                                                                                                                                                                   
00 00 02 00 00 00 03 02 00 00 00 00 00 00 00 00 00 00 00 00 00 00 00 00 00 00 00 00 00 00 00 00 00 00 00 00 00 00 00 00                                                                                                                                                     
00 02 00 00 00 03 02 02 00 00 00 00 00 00 00 00 02 02 00 00 02 07 08 04 00 02 00 02 00 02 00 00 04 00 02 00 02 00 00 00                                                                                                                                                                                                                      
02 02 02 00 00 00 00 00 00 00 00 00 00 00 00 03 02 02 00 00 00 09 10 00 00 00 03 03 02 00 00 02 00 03 00 02 14 02 00 00                                                                                                                                                                                        
02 03 02 02 00 02 00 00 00 00 04 02 00 02 00 02 02 00 00 04 02 00 00 02 00 00 00 02 02 03 02 13 02 00 00 00 03 07 08 00                                                                                                                                 
00 00 00 00 00 00 00 15 00 00 00 00 02 00 02 00 03 00 02 00 00 00 00 00 00 00 15 02 04 00 02 00 00 02 00 02 02 09 10 00                                                                                                                                            
00 00 00 00 00 00 00 00 00 00 00 00 00 00 00 00 02 00 00 00 00 00 00 15 00 00 00 03 02 02 02 02 02 00 00 00 02 03 03 00                                                                       
00 00 00 00 00 00 00 00 00 00 00 00 00 15 00 00 00 00 00 00 00 00 00 00 00 00 00 00 00 02 15 00 02 00 00 00 00 02 02 00                                                                                                                                                
00 00 00 00 00 02 00 00 00 00 00 00 00 00 00 00 00 00 00 00 00 00 00 00 00 00 00 00 00 00 00 02 00 00 00 00 00 00 00 00                                                                                                          
00 00 00 00 00 02 00 00 00 00 00 00 00 00 00 00 00 00 00 00 00 00 00 00 00 00 00 00 00 00 00 00 00 00 00 00 00 00 00 00                                                                                                                                
00 00 00 00 00 00 00 00 00 00 00 00 00 00 00 00 00 00 00 00 15 00 00 00 00 00 00 00 00 00 00 00 00 00 00 00 00 00 00 00                                                                                                                                               
00 00 00 00 00 00 00 02 00 00 00 00 15 00 00 00 00 00 00 00 00 00 00 00 00 00 00 00 00 00 00 00 00 00 00 00 15 00 00 00                                                                                                    
00 00 07 08 02 00 00 00 00 02 00 00 02 00 00 00 15 00 00 00 00 00 00 00 00 07 08 00 00 00 00 00 00 00 00 00 00 00 00 00                                                                                                                                                    
00 00 09 10 02 02 00 00 00 00 04 02 00 00 00 00 00 00 00 02 02 00 00 00 00 09 10 00 00 00 00 00 00 00 00 00 00 00 00 00                                                                                                                            
00 00 12 02 02 15 00 00 00 02 02 02 02 00 00 00 00 00 00 00 02 00 00 00 00 02 00 00 00 00 00 00 00 00 00 00 00 00 00 00                                                                                                                                             
00 02 02 03 00 00 00 00 00 00 00 02 00 02 00 00 00 00 00 00 00 00 00 00 00 00 00 00 00 00 00 00 00 03 02 00 00 00 00 00                                                                                                                               
00 02 00 00 00 00 00 00 00 00 00 00 00 00 00 00 00 00 15 00 00 00 00 00 00 02 00 00 00 00 00 00 02 02 00 02 00 00 00 00                                                                                                                               
00 00 00 00 00 00 00 00 00 00 00 00 00 00 00 00 00 00 00 00 00 00 00 00 04 02 00 00 00 00 00 02 02 00 15 00 00 00 00 00                                                                                     
00 15 00 00 00 00 00 00 00 00 00 00 00 00 00 00 00 00 00 00 00 00 00 00 00 02 03 00 00 00 02 04 02 02 00 00 00 00 00 00                                                                                                                                                                     
00 00 00 00 00 00 00 00 00 00 00 00 00 00 00 00 00 00 00 00 00 00 00 00 00 02 00 00 00 00 02 02 02 02 00 00 00 00 00 00                                                                                                                       
00 00 00 00 00 00 00 15 00 00 00 00 00 00 00 00 00 00 00 00 00 00 00 00 00 00 02 00 00 00 00 02 00 00 00 00 00 00 00 00                                                              
00 00 02 00 02 00 00 00 00 00 00 02 02 02 02 00 00 00 00 00 00 00 00 00 02 02 00 00 00 00 00 02 00 00 00 00 00 00 00 00                                                                       
00 00 02 02 00 00 00 00 00 00 00 00 00 02 02 02 00 00 00 00 15 00 00 02 00 00 00 00 00 00 00 00 00 00 00 00 00 00 00 00                                                                                                                                                                              
00 00 03 02 02 00 00 00 00 00 00 00 00 00 03 02 02 00 00 00 00 00 00 00 00 00 00 00 00 00 00 00 00 00 00 00 00 00 00 00                                                                                  
00 00 02 00 00 00 00 00 00 00 00 00 00 00 00 00 00 00 00 00 00 00 00 00 00 00 00 00 15 00 00 00 00 00 00 00 00 00 00 00                                                                                              
00 00 00 00 00 00 00 00 00 00 00 00 00 00 00 00 00 00 00 00 00 00 00 00 00 00 00 00 00 00 00 02 03 00 07 08 03 02 02 02                                                                                
00 00 00 00 00 00 00 00 00 00 00 00 00 00 00 00 00 00 00 00 00 00 00 00 00 00 00 00 00 00 02 00 02 00 09 10 02 02 04 02                                                                                                                              
00 00 00 00 00 00 00 00 00 00 00 00 00 00 00 00 00 00 00 00 00 00 00 00 00 00 00 00 00 00 00 03 02 02 03 13 02 00 00 00                                                                                                                                
00 00 00 00 00 00 00 00 00 00 00 00 00 00 00 00 00 00 00 00 00 00 00 00 00 00 00 00 00 00 02 00 03 02 00 00 15 00 00 00















































































































