14 00 00 00 00 00 00 00 04 05 05 05 05 05 05 13 08 08 08 08 08 08 08 08 08 08 08 08 08 08 08 08 08 08 08 08 08 08 12 05                                                                                                                                                                                                                                                                                                                                                                                                                                                                                                                                                                                                                                              
00 00 00 00 00 00 00 00 04 05 05 05 05 05 13 09 00 00 00 00 00 00 00 00 00 00 00 00 00 00 00 00 00 00 00 00 00 00 07 12                                                                                                                                                                                                                                                                                                               
00 00 00 00 00 00 00 00 07 08 08 08 08 08 09 00 00 00 00 00 00 00 00 00 00 00 00 00 00 00 00 00 00 00 00 00 00 00 00 04                                                                                                                         
03 00 00 00 00 00 00 00 00 00 00 00 00 00 00 00 00 00 00 00 00 00 00 00 00 00 00 00 00 00 00 00 00 00 00 00 00 00 00 04                                                                                                                                                                          
06 00 00 00 00 00 00 00 00 00 00 00 00 00 00 00 00 00 00 00 00 00 00 00 00 00 00 00 00 00 00 00 00 00 00 00 00 00 00 04                                                                                                                                                
11 02 02 03 00 00 00 00 00 00 00 00 00 00 00 00 00 00 00 00 00 00 00 00 00 00 00 00 00 00 00 00 00 00 00 00 00 00 00 04                                                                                       
05 05 05 11 03 00 00 00 00 00 00 00 00 00 00 00 00 00 00 00 00 00 00 00 00 00 00 00 00 00 00 00 00 00 00 00 00 00 00 04                                                                                                                                  
05 05 05 05 06 00 00 00 00 00 00 00 00 00 00 00 00 00 00 00 00 00 00 00 00 00 00 00 00 00 00 00 00 00 00 00 00 00 00 04                                                              
05 05 05 05 06 00 00 00 00 00 00 00 00 00 00 00 00 00 00 00 00 00 00 00 00 00 00 00 00 00 00 00 00 00 00 00 00 00 00 04                                                                                                                                                
05 05 05 05 06 00 00 00 00 00 00 00 00 00 00 00 00 00 00 00 00 00 00 00 00 00 00 01 02 02 02 02 02 02 03 00 00 00 00 04                                                                                                                                 
05 13 08 08 09 00 00 00 00 00 00 00 00 00 00 00 00 00 00 00 00 00 00 00 00 00 00 04 05 05 05 05 05 05 06 00 00 00 00 04                                                                                                                                                          
05 06 00 00 00 00 00 00 00 00 00 00 00 00 00 00 00 00 00 00 00 00 00 00 00 00 00 04 05 05 05 05 05 05 06 00 00 00 00 04                                                                                                                                                          
05 06 00 00 00 00 00 00 00 00 00 00 00 00 00 00 00 00 00 00 00 00 00 00 00 00 00 04 05 05 05 05 05 13 09 00 00 00 00 04                                                                                                    
13 09 00 00 00 00 00 00 00 00 00 00 00 00 00 00 00 00 00 00 00 00 00 00 00 00 00 04 05 05 05 05 13 09 00 00 00 00 00 04                                                                                                                                               
06 00 00 00 00 00 00 00 00 00 00 00 00 00 00 00 00 00 00 00 00 00 00 00 00 00 00 04 05 05 05 13 09 00 00 00 00 00 00 04                                                                                                 
06 00 00 00 00 00 00 00 00 00 00 00 00 00 00 00 00 00 00 00 00 00 00 00 00 00 00 04 05 05 13 09 00 00 00 00 00 00 01 10                                                                                                               
06 00 00 00 00 00 00 00 00 00 00 00 00 00 00 00 00 00 00 00 00 00 00 00 00 00 00 04 05 13 09 00 00 00 00 00 00 01 10 05                                                                                                                       
06 00 00 00 00 00 00 00 00 00 00 00 00 00 00 00 00 00 00 00 00 00 00 00 00 00 00 07 08 09 00 00 00 00 00 00 01 10 05 05                                                                                                        
06 00 00 00 00 00 00 00 00 00 00 00 00 00 00 00 00 00 00 00 00 00 00 00 00 00 00 00 00 00 00 00 00 00 00 01 10 05 05 05                                                                            
06 00 00 00 00 00 00 00 00 00 00 00 00 00 00 00 00 00 00 00 00 00 00 00 00 00 00 00 00 00 00 00 00 00 01 10 05 05 05 05                                                                                                                                                         
06 00 00 00 00 00 00 00 00 00 00 00 00 00 00 00 00 00 00 00 00 00 00 00 00 00 00 00 00 00 00 00 00 01 10 05 05 05 05 05                                                                                                    
06 00 00 00 00 00 00 00 00 00 00 00 00 00 00 00 00 00 00 00 00 00 00 00 00 00 00 00 00 00 00 00 00 04 05 05 05 05 05 05                                                              
06 00 00 00 00 00 00 00 00 00 00 00 00 00 00 00 00 00 00 00 00 00 00 00 00 00 00 00 00 00 00 00 00 04 05 05 05 05 05 05                                                                
06 00 00 00 00 00 00 00 00 00 00 00 00 00 00 00 00 00 00 00 00 00 00 00 00 00 00 00 00 00 00 00 00 07 08 08 08 08 08 08                                                                                                                                                                                                  
06 00 00 00 00 00 00 00 01 02 02 02 02 03 00 00 00 00 00 00 00 00 00 00 00 00 00 00 00 00 00 00 00 00 00 00 00 00 00 00                                                                                                  
11 03 00 00 00 01 02 02 10 05 05 05 05 11 02 02 03 00 00 00 01 02 02 03 00 00 00 00 00 00 00 00 00 00 00 00 00 00 00 00                                                                                                                   
05 11 02 02 02 10 05 05 05 05 05 05 05 05 05 05 11 02 02 02 10 05 05 11 02 02 03 00 00 00 00 00 00 00 00 00 00 00 00 00                                                                                                                     
05 05 05 05 05 05 05 05 05 05 05 05 05 05 05 05 05 05 05 05 05 05 05 05 05 05 06 00 00 00 00 00 00 00 00 00 00 00 00 00                                                                                                                                                                                 
05 05 05 05 05 05 05 05 05 05 05 05 05 05 05 05 05 05 05 05 05 05 05 05 05 05 06 00 00 00 00 00 00 00 00 00 00 00 00 00                                                                                                                                                                  
05 05 05 05 05 05 05 05 05 05 05 05 05 05 05 05 05 05 05 05 05 05 05 05 05 05 06 00 00 00 00 00 00 00 00 00 00 00 00 00


